10
10
1111111111
1000000001
1000000001
1000000001
1000000001
10000N0001
1000000001
1000000001
1000000001
1111111111